111111111111111111111111111
10000C0000000C000C00000E001
100100000000000000001000001
1001000000000000C0001111111
10010000000P000000000000001
100100000001000000000000001
100100000000000000000000001
100100000000000000000000001
111111111111111111111111111