11111111111111111111111111111111111111111
1E1000000000000C00100C0000000010000000001
10100000000100000010000010000010000000001
10100000000100000010000010000010000000001
10000000000100000010000010000010C00000001
11100000000100000010000010000010000000001
10000000000100000010000010000010000000001
10000000000100000010000010000010000000001
10000000000100000010000010000010000000001
10000000000100000010000010000010000000001
10000000000100000000000010000000000000001
1C111111111111111111111111111111111111101
10000000000100001C00010001000000000000001
10000000000000000000000000000000000000001
10000000001100011100111011100000000000001
1000000000010000C100001000100000000000001
10000000000100011100111000100000000000001
1000000000010C00010000100C100000000000001
10000000001110011100111000100000000000001
10000000000000000000000000000000000000001
10000P00000100001000010000100000000000001
1010101010010000100001000010101C101010101
11111111111111111111111111111111111111111