11111111111111111111111111111111111111111
1E1000000000000C00100C0000000010000I00001
10100000000100000010000010000010000000001
10100000000100000010000010000010000000001
10000000000100000010000010000010C00000001
11100I00000100000010000010000010000000001
100000000001000000100000100000100I0000001
10000000000100000010000010000010000000001
10000I00000100000010000010000010000000001
10000000000100000010000010000010000000001
10000000000100000000000010000000I00000001
1C111111111111111111111111111111111111101
10000000000100001C00010001000000000000001
10000I00000000000000000000000000000000001
10000000001100011100111011100000I00000001
10000I0000010000C100001000100000000000001
100000000001000111001110001000000000I0001
1000000000010C00010000100C100000000000001
10000I0000111001110011100010I000000000001
10000000000000000000000000000000000000001
10000P00000100001000010000100000000000001
1010101010010000100I01000010101C101010101
11111111111111111111111111111111111111111