11111111111111111111111111111111111111111
1E000000000100001C00010001000000000000001
10000000000000000000000000000000000000001
10000000001100011100111011100000000000001
1000000000010000C100001000100000000000001
10000000000100011100111000100000000000001
1000000000010C00010000100C100000000000001
10000000001110011100111000100000000000001
10000000000000000000000000000000000000001
10000000000100001000010000100000000000001
1010101010010000100001000010101C1010101P1
11111111111111111111111111111111111111111